#AVE = "countries/AngevinEmpire.txt" # Commented out for now until Anvegin is fully improved
#GEE = "countries/Gaelic_Empire.txt" # Not sure how this ended back here, might add it.
ABY = "countries/Abyssinia.txt"
ADR = "countries/Adriatic_Empire.txt"
AEH = "countries/Austrian_Empire.txt"
AGU = "countries/Anglo_Dutch_Union.txt"
AHE = "countries/Austro_Hungarian_Empire.txt"
AKD = "countries/Akkadian_Empire.txt"
ALC = "countries/Alsace_Lorraine.txt"
ALM = "countries/Almohad_Caliphate.txt"
ALP = "countries/Alpland.txt"
AMV = "countries/Almoravid.txt"
AOP = "countries/Abode_of_Peace.txt"
AQI = "countries/Aquitaine.txt"
ARE = "countries/Armenia_Empire.txt"
ARR = "countries/Armenia_Republic.txt"
AXE = "countries/Macedonian_Empire.txt"
BBG = "countries/Bulgarian_Empire.txt"
BEL = "countries/Belgium.txt"
BEM = "countries/British_Empire.txt"
BKL = "countries/Balkan_League.txt"
BLR = "countries/Belarus.txt"
BNL = "countries/Benelux.txt"
BRM = "countries/Burma.txt"
BRP = "countries/Brandenburg_Prussia.txt"
BSK = "countries/Bosnia_Serbia.txt"
BSQ = "countries/Basque_Country.txt"
BTC = "countries/Baltic_Union.txt"
BVE = "countries/Bremen_Verden.txt"
CAE = "countries/Central_African_Empire.txt"
CAU = "countries/Caucasia.txt"
CAZ = "countries/Carolingian_Empire.txt"
CCG = "countries/Chicago.txt"
CDB = "countries/Cordoba.txt"
CEU = "countries/Celtic_Union.txt"
CHN = "countries/China.txt"
CHX = "countries/Chad.txt"
CIS = "countries/Cisalpina.txt"
CLD = "countries/Chola.txt"
CLN = "countries/Ceylon.txt"
COD = "countries/County_of_Edessa.txt"
CSA = "countries/Confederate_States.txt"
CTG = "countries/Carthage.txt"
CTR = "countries/County_of_Tripoli.txt"
CZE = "countries/Czechoslovakia.txt"
DCA = "countries/Dacia.txt"
DCP = "countries/Ducal_Prussia.txt"
DPR = "countries/Donetsk_People_Republic.txt"
DRN = "countries/Durrani_Empire.txt"
DUM = "countries/Dual_Monarchy.txt"
ENR = "countries/Commonwealth_of_England.txt"
EOC = "countries/Empire_of_China.txt"
EPR = "countries/East_Prussia.txt"
ERO = "countries/Emilia_Romagna.txt"
ERP = "countries/Eastern_Roman_Empire.txt"
ESL = "countries/East_Slavia.txt"
ESY = "countries/United_Arab_Republic.txt"
EUR = "countries/European_Union.txt"
FIB = "countries/Franco_Iberian_Empire.txt"
FRC = "countries/Franconia.txt"
FRE = "countries/French_Empire.txt"
FRL = "countries/Frieslande.txt"
GEE = "countries/Gallic_Empire.txt"
GEP = "countries/German_Empire.txt"
GGR = "countries/Greater_German_Reich.txt"
GKR = "countries/Goguryeo.txt"
GMM = "countries/Garamantia.txt"
GNH = "countries/Ghana_Empire.txt"
GPE = "countries/Gupta_Empire.txt"
GPR = "countries/Greater_Portugal.txt"
GRP = "countries/Germany.txt"
GRR = "countries/German_Reich.txt"
GRZ = "countries/Gallo_Roman_Empire.txt"
HBV = "countries/Austria_Bavaria.txt"
HEN = "countries/Hesse_Nassau.txt"
HIM = "countries/Himalayan_Empire.txt"
HNE = "countries/Hungarian_Empire.txt"
HNS = "countries/Hanseatic_League.txt"
HRD = "countries/The_Horde.txt"
HYE = "countries/Hoysala_Empire.txt"
IBE = "countries/Iberian_Empire.txt"
IEA = "countries/Islamic_Emirate_Afghanistan.txt"
ILN = "countries/Illinois.txt"
IMA = "countries/Italian_Merchant_Alliance.txt"
ISI = "countries/Islamic_State.txt"
ITE = "countries/Italian_Empire.txt"
JAE = "countries/Empire_of_Japan.txt"
JGE = "countries/Jagiellonian_Empire.txt"
KAB = "countries/Arabian_Kingdom.txt"
KBE = "countries/Kanem_Bornu_Empire.txt"
KGG = "countries/Kingdom_of_Germany.txt"
KLR = "countries/Kalmar_Union.txt"
KNY = "countries/Kenya.txt"
KOG = "countries/Kingdom_of_God.txt"
KRV = "countries/Kievan_Rus.txt"
LGB = "countries/Langobards.txt"
LMB = "countries/Lombardy.txt"
LPR = "countries/Luhansk_People_Republic.txt"
LSE = "countries/Lusitanian_Empire.txt"
LSX = "countries/Lower_Saxony.txt"
LTE = "countries/Latin Empire.txt"
LVE = "countries/Lombardy_Venetia.txt"
LPL = "countries/Lapland.txt"
MAC = "countries/Macedon.txt"
MCI = "countries/Mercia.txt"
MGH = "countries/Maghrebia.txt"
MGN = "countries/Mingrelia.txt"
MGS = "countries/Madagascar.txt"
MJP = "countries/Majapahit_Empire.txt"
MKE = "countries/Manchuria.txt"
MKX = "countries/Makhnovia.txt"
MLE = "countries/Empire_of_Mali.txt"
MLT = "countries/Malta.txt"
MSK = "countries/Muskogee.txt"
NAZ = "countries/Nazi_Germany.txt"
NGC = "countries/North_German_Confederation.txt"
NGE = "countries/Nigeria.txt"
NKR = "countries/North_Korea.txt"
NMD = "countries/Numidia.txt"
NSE = "countries/North_Sea_Empire.txt"
OCT = "countries/Occitania.txt"
OKG = "countries/Ostrogoths.txt"
OKL = "countries/Oklahoma.txt"
OME = "countries/Omani_Empire.txt"
PCA = "countries/Phoenicia.txt"
PJJ = "countries/Pitjantjatjara.txt"
PLM = "countries/Palmyrene_Empire.txt"
PLV = "countries/Pallava.txt"
PNT = "countries/Puntland.txt"
POA = "countries/Principality_of_Antioch.txt"
PON = "countries/Pontus.txt"
PPP = "countries/Philippines.txt"
PRC = "countries/China_PRC.txt"
PSC = "countries/Polish_Swedish_Commonwealth.txt"
RGI = "countries/Rugii.txt"
RHE = "countries/Rhine_Confederation.txt"
RHO = "countries/Rhodesia.txt"
RIF = "countries/The_Rif.txt"
ROP = "countries/Roman_Republic.txt"
RSC = "countries/Catholica_Russica.txt"
RSE = "countries/Russian_Empire.txt"
RSF = "countries/Russian_Federation.txt"
RSK = "countries/Rashtrakuta.txt"
RSP = "countries/Russian_Republic.txt"
SAF = "countries/South_Africa.txt"
SBG = "countries/Siebenbuergen.txt"
SDD = "countries/Sweden_Denmark.txt"
SFF = "countries/Sweden_Finland.txt"
SNO = "countries/Sweden_Norway.txt"
SGF = "countries/South_German_Federation.txt"
SHB = "countries/Spanish_Empire.txt"
SKE = "countries/Sikh_Empire.txt"
SKR = "countries/South_Korea.txt"
SOV = "countries/Soviet_Union.txt"
SRB = "countries/Saudi_Arabia.txt"
SRE = "countries/Serbian_Empire.txt"
SSE = "countries/Swedish_Empire.txt"
SUR = "countries/Sur_Empire.txt"
SVY = "countries/Srivijaya.txt"
SVA = "countries/Savo.txt"
SWW = "countries/Sulawesi.txt"
SYT = "countries/Scythians.txt"
TAT = "countries/Tatarstan.txt"
TGK = "countries/Tengoku.txt"
THR = "countries/Third_Rome.txt"
TIE = "countries/Tibetan_Empire.txt"
TLB = "countries/Taliban.txt"
TNE = "countries/Tonga_Empire.txt"
TPP = "countries/Taiping.txt"
TRC = "countries/Terraconensis.txt"
TRN = "countries/Turan.txt"
TRR = "countries/Turkey.txt"
TSM = "countries/Tasmania.txt"
UKE = "countries/Ukraine.txt"
UKI = "countries/United_Kingdom.txt"
UMM = "countries/Ummayad_Caliphate.txt"
URL = "countries/Urals.txt"
VNM = "countries/Vietnam.txt"
VSG = "countries/Visigoths.txt"
WJJ = "countries/Greater_Wiradjuri.txt"
WNE = "countries/Wendish_Empire.txt"
WRE = "countries/Western_Roman_Empire.txt"
YUG = "countries/Yugoslavia.txt"
GFE = "countries/Greater_Finland.txt"
NGX = "countries/Nigeria_CrusaderState.txt"